###################
#                 #
# ### # ### # ### #
# # # #     # # # #
# ### # # # # ### # 
#     # # # #     #
# ##### # # ##### #
# #             # #
# # ####   #### # #
#                 #
# ##### ### ##### #
#       # #       #
# ### # ### # ### #
# # # #     # # # #
# ### # ### # ### #
#     # # # #     #
# ##### ### ##### #
#                 #
###################
