 ###################
 #                 #
 # ###### # ###### #
 #    #   #   #    #
 ## # # ##### # # ##
 #  #           #  #
 # ## ### # ### ## #
 #        #        #
 #### # ##### # ####
    # #       # #
##### # ##### # #####
        #   #        
##### # ##### # #####
    # #       # #
 #### # ##### # ####
 #        #        #
 # ## ### # ### ## #
 #  #           #  #
 ## # # ##### # # ##
 #    #   #   #    #
 # ###### # ###### #
 #                 #
 ###################